#########
#@  #  f#
## ## m #
#  $#   #
## ### ##
#     $ #
## ### ##
# m  s  #
###### ##
#  $#   #
## ##  s#
#   #   #
## ### ##
#  s  f #
## ### ##
# f     #
#########
