#########
#@  # $ #
## ##  f#
#  $#   #
## ### ##
#  f    #
## ### ##
#      $#
###### ##
#$  #   #
## ##   #
#   #  $#
## ### ##
#   f   #
## ### ##
#$      #
#########
