#########
#@  #   #
## ## t #
#  $#   #
## ### ##
#     $ #
## ### ##
#       #
###### ##
#  $# s #
## ##   #
#   #s  #
## ### ##
#b     b#
## ### ##
#b     b#
#########
