#########
#@  # $ #
## ##   #
#  $#   #
## ### ##
#       #
## ### ##
#      $#
###### ##
#$  #   #
## ##   #
#   #  $#
## ### ##
#       #
## ### ##
#$      #
#########
