#########
#@  #   #
## ##   #
#  $#   #
## ### ##
#     $ #
## ### ##
#       #
###### ##
#  $#   #
## ##   #
#   #   #
## ### ##
#       #
## ### ##
#       #
#########
